11111111111111111111111111111111111111111111111111111111111111111111111111111111
1000000000000000000C000000000000000000011111111111111111111111111111111111111111
1000000000000000000C000000000000000000E11111111111111111111111111111111111111111
1P00000000000000000C000000000000000000011111111111111111111111111111111111111111
11111111111111111111111111111111111111111111111111111111111111111111111111111111