11111111111111111111
1P0C01000000000000E1
110111000C1000111111
10000111111010000111
100C0000000010C10001
11111111111111111111