11111111111111111111
1P000100000C100000E1
11110111000010001111
10000111111010000111
11100000000000100111
11111111111111111111