1111111111111111111111111111111111111111
1N0001100000000000011111100000000000N0E1
100001000C000100N00111111011111111111111
11001110000000000001C0001000000000000001
1000011111100101111111101111111111111101
1000000000000000000000000000000000000001
1110111000100111111111101011111111111111
10000C1000000000010000001000000000000001
1000001000100100010110011111111111111101
1P000N10N000000N0C0000001C00000000000001
1111111111111111111111111111111111111111