11111111111111111111
1P0C010000000N0000E1
110111000C1000111111
10000111111010000111
100C0000N00010C100N1
11111111111111111111