11111111111111111111
1P0001000000000000E1
11110111000010001111
10000111111010000111
11100000C00000100111
11111111111111111111